00w01b11
00001111
00001111
B000111W
00101011
11110000

